```
Därpå	advmod	undersöktes
undersöktes	aux	utvidgningar
tre	nummod	utvidgningar
utvidgningar	nsubjpass	undersöktes
till	case	utvidgningar
ﬂera	nummod	smolk
samverkande	amod	smolk
smolk	dobj	undersöktes
:	punct	undersöktes
gemensamt	amod	medelvärde
medelvärde	conj	utvidgningar
,	punct	utvidgningar
gemensam	amod	median
median	conj	utvidgningar
och	cc	median
omröstning	conj	median
.	punct	undersöktes
Omröstningen	nsubj	föreföll
föreföll	cop	lämpa
lämpa	advcl	undersöktes
sig	obj	lämpa
bäst	advmod	lämpa
då	conj	lämpa
denna	nsubj	visade
visade	ccomp	föreföll
minst	advmod	visade
fördröjning	dobj	visade
för	case	upptäcka
att	ccomp	visade
upptäcka	xcomp	att
temperaturförändringar	dobj	upptäcka
och	cc	upptäcka
för	case	erfordrade
att	ccomp	erfordrade
den	nsubj	erfordrade
erfordrade	ccomp	föreföll
mindre	advmod	erfordrade
kommunikation	dobj	erfordrade
mellan	case	kommunikation
smolken	obl	kommunikation
.	punct	erfordrade
För	case	utvärdera
att	ccomp	implementerades
utvärdera	xcomp	att
algoritmerna	dobj	utvärdera
i	case	implementerades
praktiken	obl	implementerades
implementerades	ccomp	att
omröstningsalgoritmen	dobj	implementerades
på	case	implementerades
ett	det	sensornätverk
sensornätverk	obl	implementerades
bestående	amod	sensornätverk
av	case	bestående
Tmote	compound	smolk
Sky	compound	smolk
smolk	obl	bestående
under	case	implementerades
operativsystemet	obl	implementerades
TinyOS	obl	operativsystemet
.	punct	implementerades
```

The average dependency distance is 3.14.