- Dr Thomas Blanksvärd,	head: null,	dep. distance: 0
- Sto	head: Scandinavia AB, dep. distance: 1
- Scandinavia AB,	head: null, dep. distance: 0
- som	head: Blanksvärd, dep. distance: 2
- har	head: bistått, dep. distance: 1
- bistått	head: har, dep. distance: 0
- med	head: bistått, dep. distance: 1
- sin	head: kunskap, dep. distance: 1
- kunskap	head: bistått, dep. distance: 2
- och	head: hjälp, dep. distance: 1
- hjälp	head: bistått, dep. distance: 2
- under	head: gång, dep. distance: 1
- hela	head: gång, dep. distance: 1
- arbetets	head: gång, dep. distance: 1
- gång	head: bistått, dep. distance: 3
- .	head: null, dep. distance: 0

- Ett	head: tack, dep. distance: 1
- speciellt	head: tack, dep. distance: 1
- tack	head: null, dep. distance: 0
- till	head: tack, dep. distance: 1
- min	head: familj, dep. distance: 1
- familj	head: tack, dep. distance: 2
- och	head: Sofie, dep. distance: 1
- Sofie	head: tack, dep. distance: 2
- som	head: tack, dep. distance: 3
- alltid	head: finns, dep. distance: 1
- finns	head: tack, dep. distance: 4
- nära	head: finns, dep. distance: 2
- och	head: stödjer, dep. distance: 1
- stödjer	head: finns, dep. distance: 5
- mig	head: stödjer, dep. distance: 1
- .	head: null, dep. distance: 0
- Jag	head: skulle, dep. distance: 1
- skulle	head: klara, dep. distance: 1
- mig	head: klara, dep. distance: 2
- utan	head: stöd, dep. distance: 1
- Ert	head: stöd, dep. distance: 1
- stöd	head: klara, dep. distance: 3
- .	head: null, dep. distance: 0

- Stockholm,	head: null, dep. distance: 0
- december	head: null, dep. distance: 0
- 2009	head: null, dep. distance: 0
- Patrik	head: Berggren, dep. distance: 1
- Berggren	head: null, dep. distance: 0
- iii	head: null, dep. distance: 0
- Sammanfattning	head: null, dep. distance: 0

- Byggnadsbeståndet	head: Sverige, dep. distance: 1
- i	head: Sverige, dep. distance: 1
- Sverige	head: null, dep. distance: 0
- blir	head: äldre, dep. distance: 1
- bara	head: äldre, dep. distance: 1
- äldre	head: blir, dep. distance: 2
- och	head: äldre, dep. distance: 3
- äldre	head: blir, dep. distance: 4
- .	head: null, dep. distance: 0

- I	head: takt, dep. distance: 1
- takt	head: går, dep. distance: 1
- med	head: takt, dep. distance: 2
- att	head: krävs, dep. distance: 1
- åren	head: går, dep. distance: 2
- går,	head: krävs, dep. distance: 3
- så	head: krävs, dep. distance: 1
- krävs	head: null, dep. distance: 0
- ofta	head: krävs, dep. distance: 1
- olika	head: åtgärder, dep. distance: 1
- åtgärder	head: krävs, dep. distance: 2
- på	head: åtgärder, dep. distance: 1
- byggnader	head: åtgärder, dep. distance: 2
- för	head: krävs, dep. distance: 3
- att	head: skall, dep. distance: 1
- de	head: skall, dep. distance: 2
- skall	head: fortsätta, dep. distance: 1
- fortsätta	head: krävs, dep. distance: 4
- att	head: fylla, dep. distance: 1
- fylla	head: fortsätta, dep. distance: 2
- sin	head: funktion, dep. distance: 1
- funktion	head: fylla, dep. distance: 2
- .	head: null, dep. distance: 0


The average dependency distance is 2.08.