```
Prestationen	nsubj	mätes
mätes	v	är
i	prep	mätes
huvudsak	pobj	i
av	prep	mätes
hur	advmod	stor
stor	adj	kundnyttan
kundnyttan	nsubj	är
är	v	som
där	advmod	är
en	det	aspekterna
av	prep	aspekterna
aspekterna	nsubj	är
är	v	tillgänglighet
distributionernätens	nn	tillgänglighet
tillgänglighet	nsubj	beskriver
beskriver	v	och
NNM	nsubj	konstruerar
konstruerar	v	har
ett	det	referensnät
radiellt	amod	referensnät
referensnät	nsubj	har
med	prep	konstruerar
en	det	struktur
annan	adj	struktur
struktur	pobj	med
än	advmod	har
vad	det	nät
det	nsubj	har
verkliga	adj	nät
nätet	nsubj	har
har	v	beskriver
Rapporten	nsubj	beskriver
beskriver	v	mer
NNM	nsubj	beskriver
allmänt	advmod	beskriver
och	cc	beskriver
tillförlitlighetsmetoden	nsubj	beskriver
i	prep	beskriver
modellen	pobj	i
mer	advmod	utförligt
utförligt	advmod	beskriver
För	prep	att
att	cnj	har
uppnå	xcomp	för
detta	obj	uppnå
har	v	varit
intervjuer	nsubj	har
med	prep	har
modellens	nn	upphovsman
upphovsman	pobj	med
varit	v	till
till	prep	varit
hjälp	pobj	till
```

The average dependency distance is 
(1+1+2+1+2+2+1+3+3+1+2+1+1+1+1+2+1+1+1+1+1+1+1+1+1+2+1+1+3+1+1+1+1+1+1+1+1+1+1+1+1+2)/39 = 1.56