- Informanterna	------> hade	**1**
- hade	------> bakgrund	**1**
- bakgrund	------> inom	**1**
- inom	------> adderande	**1**
- adderande	------> tillverknings-­‐	**1**
- tillverknings-­‐	------> teknik,	**1**
- teknik,	------> ortopedi	**1**
- ortopedi	------> och	**1**
- och	------> protestillverkning.	**1**
- protestillverkning.	------> Teori	**3**
- Teori	------> och	**1**
- och	------> empiriskt	**1**
- empiriskt	------> underlag	**1**
- underlag	------> analyserades	**1**
- analyserades	------> utifrån	**1**
- utifrån	------> behovsbilden.	**1**
- behovsbilden.	------> Den	**3**
- Den	------> typ	**1**
- typ	------> av	**1**
- av	------> protes	**1**
- protes	------> som	**1**
- som	------> är	**1**
- är	------> bäst	**1**
- bäst	------> lämpad	**1**
- lämpad	------> att	**1**
- att	------> tillverka	**1**
- tillverka	------> med	**1**
- med	------> adderande	**1**
- adderande	------> tillverkning	**1**
- tillverkning	------> är	**1**
- är	------> en	**1**
- en	------> enkel	**1**
- enkel	------> modell	**1**
- modell	------> av	**1**
- av	------> kroppsdriven	**1**
- kroppsdriven	------> mekanisk	**1**
- mekanisk	------> armprotes.	**1**

Average dependency distance = 31 / 25 = 1.24